11111111111111
100000000C0001
10000010000001
10P00000000001
100000000E0001
11111111111111