11111111111111
10001000000001
10P000000X0001
11111000000001
10C0110E000001
11111111111111