11111111111111
100P1000000001
10000000000001
10000100000001
10C0100E000001
11111111111111