11111111111111
10001000000001
10P000000X0001
10000100000001
10C0100E000001
11111111111111