11111111111111111111111
10000000000000000000001
100E00000000X0000000001
10000000000100000000001
10000000000000000000001
1000C000000000000000001
10000000111000X00000001
10000000000000000000001
10000110000000100100001
100000000P0000000000001
10000000000000000000001
10000010110001000100001
1C00001000X000000000001
11111111111111111111111